Rose	James
Harry	Anderson
Jimmy	Nelson
Stephanie	Turner
Betty	Flores
Walter	Walker
Amanda	Edwards
Eric	Allen
Clarence	Taylor
Sean	Stewart
Jason	Garcia
Jesse	Torres
Stephen	King
Kelly	Lewis
Roy	Hill
Nicole	Morris
Joan	Diaz
Albert	Rivera
Philip	Thompson
Carol	Reed
Frances	Johnson
Joshua	Baker
Terry	Collins
Timothy	Robinson
Frank	Perez
Randy	Sanders
Kathleen	Jackson
Anne	Cox
Steven	Williams
Judy	Richardson
Andrew	Davis
Todd	Simmons
Catherine	Phillips
Keith	Rodriguez
Annie	Gonzales
Pamela	Wilson
Adam	Moore
Billy	Henderson
Johnny	Murphy
Nancy	Alexander
Kathryn	Lee
Gregory	Hughes
Alan	Brooks
Deborah	Gonzalez
Steve	Powell
Chris	Kelly
Irene	Howard
Phillip	Ross
Richard	Carter
Mildred	Brown
Roger	Smith
Ronald	Coleman
Cynthia	Scott
Fred	Martin
Louise	Clark
Phyllis	Peterson
Tina	Russell
Jeffrey	Harris
Lisa	Sanchez
Earl	Morgan
Michelle	Watson
Anthony	Evans
Andrea	Lopez
Ryan	Foster
Margaret	Rogers
Debra	Bailey
Karen	Price
Carl	Butler
Justin	Ramirez
Shawn	Green
Paula	Jenkins
Jacqueline	Cooper
Rachel	Washington
Benjamin	Campbell
Wanda	Wright
Peter	Bennett
Elizabeth	Mitchell
Janice	Parker
Howard	Barnes
Brian	Young
Linda	Griffin
Daniel	Patterson
James	Wood
Jennifer	Hall
Samuel	Cook
Ernest	Thomas
Susan	Miller
Lillian	Long
Dennis	Adams
Denise	Jones
Aaron	Hernandez
Alice	Martinez
Lori	White
Jessica	Bell
Dorothy	Gray
Arthur	Bryant
Joyce	Ward
Marilyn	Roberts